マンション名,都,区,区域,間取り,間取りDK,間取りK,間取りL,間取りS,築年数,建物高さ,階,専有面積,賃料+管理費,敷/礼,路線1,駅1,徒歩1,賃料,管理費,敷金,礼金,予測価格,test-predict,ratio[%]
ＪＲ総武線御茶ノ水駅10階建築24年,東京都,千代田区,外神田２,1,1,0,1,0,24,10,4,36,145000,290000,ＪＲ総武線,御茶ノ水駅,4,145000,0,145000,145000,145000,0,0.0
ＪＲ中央線水道橋駅10階建築8年,東京都,千代田区,神田三崎町２,1,0,0,0,0,8,10,6,25,121000,109000,ＪＲ中央線,水道橋駅,2,109000,12000,0,109000,121000,0,0.0
東京メトロ日比谷線小伝馬町駅8階建築24年,東京都,千代田区,岩本町１,3,1,0,1,0,24,8,7,90,278300,542600,東京メトロ日比谷線,小伝馬町駅,4,271300,7000,271300,271300,290000,-11700,4.2
ハイツ神田岩本町,東京都,千代田区,東神田１,1,0,0,0,0,42,11,11,22,70000,128000,ＪＲ総武線快速,馬喰町駅,3,64000,6000,64000,64000,95000,-25000,35.7
パトリア九段下,東京都,千代田区,九段北１,1,0,0,0,0,17,14,2,25,110000,100000,東京メトロ東西線,九段下駅,1,100000,10000,100000,0,110000,0,0.0
マートルコート麹町,東京都,千代田区,九段南３,1,0,0,0,0,40,14,7,37,160000,450000,ＪＲ総武線,市ケ谷駅,8,150000,10000,300000,150000,160000,0,0.0
グレイシス三番町,東京都,千代田区,三番町,1,1,0,1,0,0,9,6,46,235000,440000,東京メトロ有楽町線,市ケ谷駅,7,220000,15000,220000,220000,230000,5000,2.1
ケーズ麹町,東京都,千代田区,麹町１,1,0,0,0,0,18,9,2,32,148000,276000,東京メトロ半蔵門線,半蔵門駅,1,138000,10000,138000,138000,148000,0,0.0
ＪＲ中央線飯田橋駅7階建築44年,東京都,千代田区,富士見２,1,1,0,1,0,44,7,1,44,160000,160000,ＪＲ中央線,飯田橋駅,2,160000,0,160000,0,160000,0,0.0
ハ－スグラ－フ,東京都,千代田区,九段南３,1,0,0,0,0,22,6,2,33,130000,125000,ＪＲ中央線,市ケ谷駅,6,125000,5000,125000,0,114000,16000,12.3
スカイコート神田,東京都,千代田区,岩本町１,1,0,0,0,0,21,12,6,22,91000,39000,東京メトロ日比谷線,小伝馬町駅,3,78000,13000,0,39000,91000,0,0.0
ＪＲ中央線市ケ谷駅地下1地上14階建新築,東京都,千代田区,四番町,1,1,0,1,0,0,14,7,37,300000,600000,ＪＲ中央線,市ケ谷駅,5,300000,0,300000,300000,300000,0,0.0
レジディア大手町北,東京都,千代田区,内神田１,1,0,0,0,0,4,13,2,25,149000,278000,ＪＲ山手線,神田駅,5,139000,10000,139000,139000,150000,-1000,0.7
ＪＲ山手線秋葉原駅10階建築7年,東京都,千代田区,外神田２,1,0,0,0,0,7,10,4,25,130000,240000,ＪＲ山手線,秋葉原駅,10,120000,10000,120000,120000,130000,0,0.0
プレジリア九段下,東京都,千代田区,九段北１,1,1,0,1,0,8,10,7,35,153000,145000,東京メトロ東西線,九段下駅,4,145000,8000,145000,0,160000,-7000,4.6
ＪＲ山手線秋葉原駅13階建築18年,東京都,千代田区,神田東紺屋町,1,0,0,0,0,18,13,11,22,90000,160000,ＪＲ山手線,秋葉原駅,7,80000,10000,80000,80000,93000,-3000,3.3
FREESIATERRACE,東京都,千代田区,九段南３,1,1,0,1,0,11,15,6,40,177000,486000,東京メトロ南北線,市ケ谷駅,6,162000,15000,162000,324000,179000,-2000,1.1
都営新宿線小川町駅11階建築2年,東京都,千代田区,神田小川町３,1,1,0,1,0,2,11,10,51,235000,450000,都営新宿線,小川町駅,6,225000,10000,225000,225000,239000,-4000,1.7
東京メトロ有楽町線飯田橋駅10階建築20年,東京都,千代田区,富士見２,1,0,0,0,0,20,10,9,22,114000,108000,東京メトロ有楽町線,飯田橋駅,4,108000,6000,108000,0,105000,9000,7.9
ＪＲ山手線神田駅12階建築6年,東京都,千代田区,神田司町２,2,0,0,0,0,6,12,12,33,156000,292000,ＪＲ山手線,神田駅,7,146000,10000,146000,146000,151000,5000,3.2
ミレニアムガーデンコート,東京都,千代田区,二番町,1,1,0,1,0,23,17,3,53,320000,640000,東京メトロ有楽町線,麹町駅,4,320000,0,320000,320000,298000,22000,6.9
CALSSYHOUSE大手町　【クラッシィハウス大手町】,東京都,千代田区,内神田１,1,0,0,0,0,0,16,3,28,150000,280000,ＪＲ山手線,神田駅,8,140000,10000,140000,140000,150000,0,0.0
Ｒｕｙｇｏ御茶ノ水,東京都,千代田区,神田猿楽町２,1,0,0,0,0,0,5,5,20,114000,0,東京メトロ半蔵門線,神保町駅,6,104000,10000,0,0,116000,-2000,1.8
エステムプラザ丸の内NORTHRISE,東京都,千代田区,内神田１,1,0,0,0,0,16,12,4,22,99000,84000,ＪＲ山手線,神田駅,7,84000,15000,0,84000,96000,3000,3.0
シャルマン新光松富町,東京都,千代田区,外神田４,1,0,0,0,0,3,5,3,28,160000,308000,東京メトロ銀座線,末広町駅,2,154000,6000,154000,154000,150000,10000,6.2
東京メトロ東西線九段下駅10階建築42年,東京都,千代田区,神田神保町３,1,0,0,0,0,42,10,6,16,75000,138000,東京メトロ東西線,九段下駅,3,69000,6000,69000,69000,75000,0,0.0
ビュロー平河町（ビューロヒラカワチョウ）,東京都,千代田区,平河町１,1,1,0,1,0,24,8,4,73,280000,560000,東京メトロ半蔵門線,半蔵門駅,3,280000,0,280000,280000,302000,-22000,7.9
アルファグランデ千桜タワー,東京都,千代田区,神田東松下町,2,1,0,1,0,5,25,9,56,380000,696000,都営新宿線,岩本町駅,1,348000,32000,348000,348000,380000,0,0.0
ＪＲ総武線市ケ谷駅地下2地上17階建築16年,東京都,千代田区,四番町,2,1,0,1,0,16,17,8,63,350000,1050000,ＪＲ総武線,市ケ谷駅,3,350000,0,700000,350000,380000,-30000,8.6
レグノ・フォルテ二番町,東京都,千代田区,二番町,1,0,0,0,0,17,14,13,25,129000,129000,ＪＲ中央線,四ツ谷駅,4,129000,0,0,129000,129000,0,0.0
ＪＲ山手線神田駅12階建築4年,東京都,千代田区,神田須田町２,1,0,0,0,0,4,12,5,20,113000,0,ＪＲ山手線,神田駅,5,98000,15000,0,0,113000,0,0.0
そのビル,東京都,千代田区,西神田２,1,0,0,0,0,3,3,3,21,103000,300000,都営三田線,神保町駅,4,100000,3000,200000,100000,113000,-10000,9.7
イン　スタイル　スクエア,東京都,千代田区,岩本町２,1,0,0,0,0,17,14,8,24,103000,103000,都営新宿線,岩本町駅,2,103000,0,103000,0,108000,-5000,4.9
九段千鳥ヶ淵テラス,東京都,千代田区,九段南２,1,1,0,1,0,9,12,3,37,176000,340000,東京メトロ東西線,九段下駅,5,170000,6000,170000,170000,176000,0,0.0
東京メトロ日比谷線秋葉原駅12階建築16年,東京都,千代田区,神田佐久間河岸,1,0,0,0,0,16,12,3,25,103000,186000,東京メトロ日比谷線,秋葉原駅,3,93000,10000,93000,93000,103000,0,0.0
プラウドフラット東神田,東京都,千代田区,東神田１,1,0,0,0,0,8,13,5,30,139000,131000,ＪＲ総武線快速,馬喰町駅,3,131000,8000,131000,0,139000,0,0.0
OLIO東神田　【オリオ東神田】,東京都,千代田区,東神田３,1,0,0,0,0,21,13,10,25,95000,190000,ＪＲ山手線,秋葉原駅,7,95000,0,95000,95000,108000,-13000,13.7
テルセーロ三鈴,東京都,千代田区,岩本町１,2,1,0,1,0,25,8,4,64,227000,430000,東京メトロ日比谷線,小伝馬町駅,5,215000,12000,215000,215000,227000,0,0.0
KDXレジデンス半蔵門,東京都,千代田区,麹町２,1,0,0,0,0,20,13,2,31,150000,140000,東京メトロ半蔵門線,半蔵門駅,2,140000,10000,140000,0,150000,0,0.0
ロイジェント東神田,東京都,千代田区,外神田１,2,1,0,1,0,5,13,12,70,345000,666000,都営新宿線,岩本町駅,5,333000,12000,333000,333000,300000,45000,13.0
コンフォリア秋葉原イースト,東京都,千代田区,東神田２,1,0,0,0,0,7,12,6,25,124000,118000,ＪＲ山手線,秋葉原駅,8,118000,6000,118000,0,124000,0,0.0
デュオ・スカーラ御茶ノ水II,東京都,千代田区,神田淡路町１,1,0,0,0,0,20,8,6,23,98000,184000,東京メトロ千代田線,新御茶ノ水駅,1,92000,6000,92000,92000,98000,0,0.0
ＪＲ山手線神田駅4階建築56年,東京都,千代田区,神田須田町１,1,1,0,1,1,56,4,4,38,150000,150000,ＪＲ山手線,神田駅,8,150000,0,0,150000,150000,0,0.0
都営新宿線岩本町駅12階建築17年,東京都,千代田区,岩本町３,1,0,0,0,0,17,12,12,22,89000,178000,都営新宿線,岩本町駅,3,89000,0,89000,89000,89000,0,0.0
東京メトロ半蔵門線半蔵門駅10階建新築,東京都,千代田区,平河町１,2,1,0,0,0,0,10,5,40,275000,260000,東京メトロ半蔵門線,半蔵門駅,4,260000,15000,0,260000,265000,10000,3.6
ミライズレジデンシャル九段,東京都,千代田区,九段北１,1,0,0,0,0,7,13,4,32,164000,154000,東京メトロ東西線,九段下駅,3,154000,10000,154000,0,164000,0,0.0
ライオンズステーションプラザ半蔵門,東京都,千代田区,麹町１,1,0,0,0,0,41,10,6,17,82000,154000,東京メトロ半蔵門線,半蔵門駅,2,77000,5000,77000,77000,82000,0,0.0
プレジール三番町,東京都,千代田区,三番町,1,1,0,0,0,24,8,6,31,130000,250000,都営新宿線,市ケ谷駅,4,125000,5000,125000,125000,138000,-8000,6.2
ＪＲ総武線浅草橋駅11階建築15年,東京都,千代田区,東神田３,1,1,0,1,0,15,11,10,40,147000,137000,ＪＲ総武線,浅草橋駅,2,137000,10000,0,137000,160000,-13000,8.8
ＪＲ中央線四ツ谷駅13階建築7年,東京都,千代田区,隼町,1,1,0,0,0,7,13,3,33,205500,195000,ＪＲ中央線,四ツ谷駅,15,195000,10500,0,195000,205500,0,0.0
都営新宿線市ケ谷駅11階建築19年,東京都,千代田区,九段北４,1,1,0,1,1,19,11,10,47,230000,460000,都営新宿線,市ケ谷駅,1,230000,0,230000,230000,225000,5000,2.2
アール平河町,東京都,千代田区,平河町２,3,1,0,0,0,40,4,3,53,199000,398000,東京メトロ南北線,永田町駅,3,199000,0,199000,199000,199000,0,0.0
東京メトロ半蔵門線半蔵門駅15階建築5年,東京都,千代田区,一番町,3,1,0,1,0,5,15,14,151,1100000,2200000,東京メトロ半蔵門線,半蔵門駅,3,1100000,0,1100000,1100000,1200000,-100000,9.1
東京メトロ半蔵門線大手町駅12階建築5年,東京都,千代田区,神田錦町３,1,0,0,0,0,5,12,3,30,146000,69000,東京メトロ半蔵門線,大手町駅,9,138000,8000,69000,0,146000,0,0.0
ＪＲ山手線秋葉原駅11階建築22年,東京都,千代田区,東神田２,1,0,0,0,0,22,11,3,22,90000,80000,ＪＲ山手線,秋葉原駅,6,80000,10000,0,80000,90000,0,0.0
東京メトロ銀座線神田駅地下1地上13階建築19年,東京都,千代田区,神田多町２,1,0,0,0,0,19,13,11,22,93000,83000,東京メトロ銀座線,神田駅,2,83000,10000,83000,0,93000,0,0.0
コノエ三番町,東京都,千代田区,三番町,1,1,0,0,0,11,12,7,30,160000,320000,ＪＲ中央線,市ケ谷駅,9,160000,0,160000,160000,160000,0,0.0
シティインデックス千代田秋葉原,東京都,千代田区,神田佐久間町３,1,1,0,1,0,6,14,12,45,235000,450000,東京メトロ日比谷線,秋葉原駅,5,225000,10000,225000,225000,220000,15000,6.4
東京メトロ半蔵門線神保町駅8階建築21年,東京都,千代田区,神田小川町３,1,1,0,1,0,21,8,2,60,250000,238000,東京メトロ半蔵門線,神保町駅,5,238000,12000,238000,0,249000,1000,0.4
正栄ビル,東京都,千代田区,東神田３,2,1,0,0,0,35,4,4,38,125000,250000,ＪＲ総武線,浅草橋駅,4,125000,0,125000,125000,150000,-25000,20.0
XEBECOTEMACHI　【ジーベック大手町】,東京都,千代田区,神田錦町１,1,0,0,0,0,6,13,6,26,122000,113000,ＪＲ山手線,神田駅,9,113000,9000,113000,0,122000,0,0.0
ポレスター千代田御茶ノ水,東京都,千代田区,外神田２,1,1,0,1,0,10,10,9,41,180000,340000,ＪＲ総武線,御茶ノ水駅,8,170000,10000,170000,170000,180000,0,0.0
リビオレゾン内神田,東京都,千代田区,内神田１,1,1,0,1,0,4,13,9,32,180000,340000,ＪＲ山手線,神田駅,7,170000,10000,170000,170000,160000,20000,11.1
カーサフジマ,東京都,千代田区,九段北４,1,0,0,0,0,42,9,3,31,119000,238000,都営新宿線,市ケ谷駅,3,119000,0,119000,119000,119000,0,0.0
グラックス市ヶ谷一口坂,東京都,千代田区,九段北４,1,0,0,0,0,18,12,2,26,117000,105000,都営新宿線,市ケ谷駅,5,105000,12000,105000,0,110000,7000,6.0
デュアレス千代田三崎町,東京都,千代田区,神田三崎町３,1,0,0,0,0,8,11,3,25,154500,144000,都営三田線,水道橋駅,10,144000,10500,0,144000,154500,0,0.0
マストライフ神田錦町,東京都,千代田区,神田錦町２,1,0,0,0,0,5,13,9,25,127880,238000,東京メトロ千代田線,大手町駅,6,119000,8880,119000,119000,130000,-2120,1.7
ウィン神田,東京都,千代田区,神田須田町１,1,0,0,0,0,42,11,9,21,95000,85000,東京メトロ銀座線,神田駅,4,85000,10000,85000,0,95000,0,0.0
二番町パークフォレスト,東京都,千代田区,二番町,2,1,0,1,0,19,14,14,130,630000,2520000,東京メトロ有楽町線,麹町駅,4,630000,0,1260000,1260000,630000,0,0.0
東京メトロ半蔵門線神保町駅8階建築7年,東京都,千代田区,神田神保町１,1,0,0,0,0,7,8,2,21,109000,99000,東京メトロ半蔵門線,神保町駅,3,99000,10000,99000,0,107000,2000,1.8
レジディア神田,東京都,千代田区,神田多町２,1,1,0,1,0,17,13,5,30,153000,286000,ＪＲ山手線,神田駅,3,143000,10000,143000,143000,155000,-2000,1.3
カスタリアお茶の水,東京都,千代田区,神田小川町３,1,1,0,1,0,21,8,2,60,250000,238000,東京メトロ半蔵門線,神保町駅,5,238000,12000,238000,0,249000,1000,0.4
東京メトロ日比谷線秋葉原駅12階建築4年,東京都,千代田区,東神田２,1,0,0,0,0,4,12,6,25,129000,240000,東京メトロ日比谷線,秋葉原駅,6,120000,9000,120000,120000,130000,-1000,0.8
東京メトロ有楽町線飯田橋駅10階建新築,東京都,千代田区,富士見２,1,1,0,1,0,0,10,1,33,179000,169000,東京メトロ有楽町線,飯田橋駅,3,169000,10000,169000,0,154000,25000,14.0
ラ・トゥール千代田,東京都,千代田区,西神田３,1,0,0,0,0,20,32,21,43,260000,520000,都営三田線,神保町駅,6,260000,0,520000,0,218000,42000,16.2
ＪＲ山手線神田駅9階建築3年,東京都,千代田区,岩本町２,1,1,0,1,0,3,9,7,36,165000,300000,ＪＲ山手線,神田駅,8,150000,15000,150000,150000,165000,0,0.0
東京メトロ銀座線神田駅10階建築8年,東京都,千代田区,鍛冶町２,1,1,0,0,0,8,10,2,30,150000,280000,東京メトロ銀座線,神田駅,2,140000,10000,140000,140000,150000,0,0.0
クレール千代田岩本町,東京都,千代田区,岩本町２,1,0,0,0,0,11,11,11,30,119000,110000,都営新宿線,岩本町駅,5,110000,9000,0,110000,119000,0,0.0
東京メトロ有楽町線麹町駅地下3地上26階建築5年,東京都,千代田区,麹町３,1,1,0,1,0,5,26,4,50,283000,566000,東京メトロ有楽町線,麹町駅,1,283000,0,283000,283000,298000,-15000,5.3
東京パークタワー,東京都,千代田区,神田神保町１,1,1,0,1,0,21,29,10,39,210000,600000,東京メトロ半蔵門線,神保町駅,1,200000,10000,400000,200000,295000,-85000,40.5
ＪＲ総武線四ツ谷駅9階建築9年,東京都,千代田区,麹町５,1,0,0,0,0,9,9,2,25,130000,260000,ＪＲ総武線,四ツ谷駅,5,130000,0,130000,130000,139000,-9000,6.9
リベア東神田,東京都,千代田区,東神田３,1,1,0,0,0,15,11,10,40,147000,137000,ＪＲ総武線,浅草橋駅,2,137000,10000,0,137000,197000,-50000,34.0
ミテッツァ千代田三崎町,東京都,千代田区,神田三崎町３,1,0,0,0,0,12,12,4,25,111000,96000,ＪＲ中央線,水道橋駅,5,96000,15000,96000,0,108000,3000,2.7
プライムアーバン飯田橋,東京都,千代田区,飯田橋４,1,0,0,0,0,18,14,2,22,100000,94000,ＪＲ中央線,飯田橋駅,1,94000,6000,94000,0,105000,-5000,5.0
パーク・ノヴァ九段,東京都,千代田区,九段南４,1,0,0,0,0,34,7,2,32,116000,318000,ＪＲ中央線,市ケ谷駅,5,106000,10000,212000,106000,131700,-15700,13.5
サンハイム三番町,東京都,千代田区,三番町,2,1,0,1,0,43,8,2,69,280000,530000,東京メトロ半蔵門線,半蔵門駅,6,265000,15000,265000,265000,200000,80000,28.6
東京メトロ半蔵門線半蔵門駅10階建築11年,東京都,千代田区,一番町,1,1,0,1,0,11,10,4,40,200000,600000,東京メトロ半蔵門線,半蔵門駅,4,200000,0,200000,400000,182000,18000,9.0
平河町プラザ,東京都,千代田区,平河町１,1,1,0,0,0,46,8,4,24,100000,194000,東京メトロ半蔵門線,半蔵門駅,3,97000,3000,97000,97000,128000,-28000,28.0
東京メトロ半蔵門線神保町駅地下2地上10階建築22年,東京都,千代田区,神田神保町２,1,1,0,1,0,22,10,9,84,350000,700000,東京メトロ半蔵門線,神保町駅,4,350000,0,350000,350000,290000,60000,17.1
デュオ・スカーラ御茶ノ水,東京都,千代田区,神田小川町２,1,1,0,1,0,22,8,5,37,150000,284000,都営新宿線,小川町駅,5,142000,8000,142000,142000,145000,5000,3.3
ヒルトップ半蔵門,東京都,千代田区,一番町,2,1,0,1,0,22,7,5,75,356000,660000,東京メトロ半蔵門線,半蔵門駅,3,330000,26000,330000,330000,356000,0,0.0
プラース千代田富士見,東京都,千代田区,富士見２,1,0,0,0,0,14,9,6,22,111000,206000,東京メトロ東西線,飯田橋駅,4,103000,8000,103000,103000,111000,0,0.0
東京メトロ半蔵門線大手町駅地下1地上14階建新築,東京都,千代田区,神田錦町１,1,1,0,1,0,0,14,7,27,187000,0,東京メトロ半蔵門線,大手町駅,7,167000,20000,0,0,184000,3000,1.6
CSビル,東京都,千代田区,神田神保町３,2,1,0,1,0,49,4,3,106,524000,1470000,都営新宿線,九段下駅,3,490000,34000,980000,490000,400000,124000,23.7
アーノンブライト一番町,東京都,千代田区,一番町,1,0,0,0,0,18,11,4,47,157000,302000,東京メトロ半蔵門線,半蔵門駅,1,151000,6000,151000,151000,157000,0,0.0
ＪＲ中央線東京駅14階建築3年,東京都,千代田区,内神田３,1,0,0,0,0,3,14,8,32,149500,141000,ＪＲ中央線,東京駅,13,141000,8500,0,141000,149500,0,0.0
東京メトロ半蔵門線神保町駅地下1地上5階建新築,東京都,千代田区,神田猿楽町２,1,0,0,0,0,0,5,5,20,114000,0,東京メトロ半蔵門線,神保町駅,6,104000,10000,0,0,116000,-2000,1.8
グランスイート千代田麹町,東京都,千代田区,麹町６,2,1,0,1,0,4,14,9,80,460000,1380000,ＪＲ中央線,四ツ谷駅,2,460000,0,920000,460000,760000,-300000,65.2
ルームスキノカ,東京都,千代田区,岩本町２,1,0,0,0,0,11,13,10,25,110880,204000,ＪＲ山手線,神田駅,8,102000,8880,102000,102000,119000,-8120,7.3
東京メトロ半蔵門線神保町駅11階建築19年,東京都,千代田区,神田神保町２,1,0,0,0,0,19,11,8,26,127000,119000,東京メトロ半蔵門線,神保町駅,4,119000,8000,119000,0,120500,6500,5.1
ＪＲ総武線四ツ谷駅14階建築17年,東京都,千代田区,二番町,1,0,0,0,0,17,14,13,25,129000,129000,ＪＲ総武線,四ツ谷駅,4,129000,0,0,129000,129000,0,0.0
RAXA神田須田町ラクサ神田須田町,東京都,千代田区,神田須田町１,1,0,0,0,0,3,10,7,30,138500,128000,東京メトロ銀座線,神田駅,2,128000,10500,0,128000,138500,0,0.0
ilusaイルサ,東京都,千代田区,神田小川町３,1,0,0,0,0,21,6,3,47,201000,374000,都営三田線,神保町駅,4,187000,14000,374000,0,171000,30000,14.9
東京メトロ半蔵門線神保町駅地下1地上6階建築21年,東京都,千代田区,神田小川町３,1,0,0,0,0,21,6,3,47,201000,374000,東京メトロ半蔵門線,神保町駅,4,187000,14000,374000,0,171000,30000,14.9
東京メトロ東西線飯田橋駅地下1地上13階建築8年,東京都,千代田区,飯田橋２,1,0,0,0,0,8,13,8,25,139000,258000,東京メトロ東西線,飯田橋駅,5,129000,10000,129000,129000,139000,0,0.0
ＪＲ中央線飯田橋駅8階建築40年,東京都,千代田区,飯田橋２,2,1,0,0,0,40,8,3,42,160000,640000,ＪＲ中央線,飯田橋駅,7,160000,0,320000,320000,160000,0,0.0
麹町二番町マンション,東京都,千代田区,二番町,1,0,0,0,0,15,10,7,31,146000,276000,東京メトロ有楽町線,麹町駅,3,138000,8000,138000,138000,146000,0,0.0
ＪＲ山手線神田駅12階建築19年,東京都,千代田区,神田多町２,1,0,0,0,0,19,12,1,22,94000,168000,ＪＲ山手線,神田駅,4,84000,10000,84000,84000,92000,2000,2.1
ＪＲ山手線神田駅10階建築24年,東京都,千代田区,内神田１,1,0,0,0,0,24,10,10,41,173000,465000,ＪＲ山手線,神田駅,9,155000,18000,465000,0,151000,22000,12.7
東京メトロ千代田線大手町駅12階建築3年,東京都,千代田区,神田錦町３,1,1,0,1,0,3,12,7,41,192000,576000,東京メトロ千代田線,大手町駅,10,192000,0,192000,384000,255000,-63000,32.8
東京メトロ日比谷線秋葉原駅9階建築18年,東京都,千代田区,神田和泉町,1,0,0,0,0,18,9,9,23,104000,96000,東京メトロ日比谷線,秋葉原駅,6,96000,8000,0,96000,122500,-18500,17.8
ジオ千代田大手町,東京都,千代田区,内神田１,1,1,0,0,0,4,13,11,36,200000,380000,東京メトロ丸ノ内線,大手町駅,5,190000,10000,190000,190000,200000,0,0.0
東京メトロ有楽町線市ケ谷駅12階建築5年,東京都,千代田区,三番町,2,1,0,1,0,5,12,3,57,290000,290000,東京メトロ有楽町線,市ケ谷駅,7,290000,0,290000,0,310000,-20000,6.9
東京メトロ半蔵門線半蔵門駅14階建築1年,東京都,千代田区,一番町,1,1,0,1,0,1,14,7,56,385000,740000,東京メトロ半蔵門線,半蔵門駅,3,370000,15000,370000,370000,388000,-3000,0.8
ＪＲ総武線御茶ノ水駅6階建築4年,東京都,千代田区,外神田２,1,0,0,0,0,4,6,2,25,114000,109000,ＪＲ総武線,御茶ノ水駅,6,109000,5000,0,109000,114000,0,0.0
ＪＲ山手線神田駅10階建築16年,東京都,千代田区,神田紺屋町,1,1,0,1,0,16,10,10,51,239000,458000,ＪＲ山手線,神田駅,4,229000,10000,229000,229000,239000,0,0.0
クラヤビル,東京都,千代田区,神田神保町３,1,0,0,0,0,74,2,2,25,68000,136000,東京メトロ東西線,九段下駅,2,68000,0,68000,68000,170500,-102500,150.7
ＪＲ山手線神田駅8階建築5年,東京都,千代田区,神田富山町,1,1,0,1,0,5,8,3,39,185000,340000,ＪＲ山手線,神田駅,3,170000,15000,170000,170000,170000,15000,8.1
USビル,東京都,千代田区,平河町１,2,1,0,1,0,42,9,9,112,500000,1000000,東京メトロ半蔵門線,半蔵門駅,3,500000,0,1000000,0,500000,0,0.0
東京メトロ半蔵門線半蔵門駅10階建築40年,東京都,千代田区,隼町,1,0,0,0,0,40,10,4,27,102000,196000,東京メトロ半蔵門線,半蔵門駅,4,98000,4000,98000,98000,102000,0,0.0
レヴァンテ,東京都,千代田区,東神田２,1,1,0,0,0,29,5,2,40,120000,0,ＪＲ山手線,秋葉原駅,8,120000,0,0,0,129000,-9000,7.5
千代田ファーストハイツ,東京都,千代田区,西神田３,1,1,0,1,0,25,17,17,58,318000,606000,東京メトロ半蔵門線,神保町駅,5,303000,15000,606000,0,310000,8000,2.5
リヴシティ神田,東京都,千代田区,神田富山町,1,1,0,1,0,12,13,10,45,201500,0,東京メトロ銀座線,神田駅,3,181000,20500,0,0,201500,0,0.0
東京メトロ半蔵門線永田町駅4階建築41年,東京都,千代田区,平河町２,1,1,0,1,0,41,4,3,36,120600,0,東京メトロ半蔵門線,永田町駅,3,111100,9500,0,0,145000,-24400,20.2
ＪＲ総武線水道橋駅5階建築7年,東京都,千代田区,神田三崎町２,1,0,0,0,0,7,5,3,22,103000,186000,ＪＲ総武線,水道橋駅,4,93000,10000,93000,93000,97500,5500,5.3
東京メトロ半蔵門線半蔵門駅10階建築10年,東京都,千代田区,麹町２,1,0,0,0,0,10,10,5,25,130000,240000,東京メトロ半蔵門線,半蔵門駅,2,120000,10000,120000,120000,130000,0,0.0
東京メトロ南北線市ケ谷駅7階建築23年,東京都,千代田区,九段南３,1,0,0,0,0,23,7,4,22,93000,0,東京メトロ南北線,市ケ谷駅,5,87000,6000,0,0,95000,-2000,2.2
ＪＲ総武線浅草橋駅12階建築8年,東京都,千代田区,東神田３,1,1,0,1,0,8,12,9,35,160000,320000,ＪＲ総武線,浅草橋駅,2,160000,0,160000,160000,160000,0,0.0
ＪＲ山手線秋葉原駅11階建築22年,東京都,千代田区,東神田２,1,0,0,0,0,22,11,2,23,91500,85500,ＪＲ山手線,秋葉原駅,7,85500,6000,0,85500,91500,0,0.0
都営新宿線岩本町駅10階建築1年,東京都,千代田区,東神田２,2,1,0,1,0,1,10,8,61,279500,271000,都営新宿線,岩本町駅,5,271000,8500,0,271000,279500,0,0.0
ディム秋葉原,東京都,千代田区,神田和泉町,1,1,0,0,0,19,9,8,35,140000,130000,ＪＲ山手線,秋葉原駅,3,130000,10000,0,130000,140000,0,0.0
スカイコート九段下敷礼なし,東京都,千代田区,飯田橋２,1,0,0,0,0,19,12,6,23,112500,102000,東京メトロ東西線,九段下駅,4,102000,10500,0,102000,92000,20500,18.2
レジディア神田岩本町,東京都,千代田区,岩本町２,1,0,0,0,0,19,15,7,22,96000,172000,都営新宿線,岩本町駅,3,86000,10000,86000,86000,94500,1500,1.6
ドミール五番町(ドミールゴバンチョウ),東京都,千代田区,五番町,3,1,0,1,0,52,13,11,98,350000,693000,ＪＲ中央線,市ケ谷駅,3,330000,20000,330000,363000,350000,0,0.0
都営新宿線神保町駅地下1地上11階建築22年,東京都,千代田区,神田神保町２,1,0,0,0,0,22,11,10,22,100000,90000,都営新宿線,神保町駅,1,90000,10000,0,90000,85500,14500,14.5
ＪＲ山手線秋葉原駅12階建築18年,東京都,千代田区,東神田１,1,0,0,0,0,18,12,8,23,89000,0,ＪＲ山手線,秋葉原駅,9,79000,10000,0,0,96000,-7000,7.9
ＪＲ山手線神田駅13階建築18年,東京都,千代田区,岩本町２,1,0,0,0,0,18,13,10,31,129000,119000,ＪＲ山手線,神田駅,7,119000,10000,0,119000,129000,0,0.0
RESIDIA神田淡路町　【レジディア神田淡路町】,東京都,千代田区,神田淡路町２,1,0,0,0,0,8,12,3,27,131000,242000,ＪＲ山手線,秋葉原駅,8,121000,10000,121000,121000,131000,0,0.0
リビオレゾン千代田岩本町ルジェンテ,東京都,千代田区,岩本町２,1,0,0,0,0,3,14,5,25,110000,100000,都営新宿線,岩本町駅,4,100000,10000,100000,0,128000,-18000,16.4
都営浅草線浅草橋駅7階建築43年,東京都,千代田区,東神田３,1,1,0,1,0,43,7,5,36,163000,296000,都営浅草線,浅草橋駅,4,148000,15000,148000,148000,163000,0,0.0
東京メトロ東西線飯田橋駅12階建築12年,東京都,千代田区,神田神保町３,1,0,0,0,0,12,12,3,25,130000,240000,東京メトロ東西線,飯田橋駅,12,120000,10000,120000,120000,130000,0,0.0
東京メトロ銀座線末広町駅5階建築4年,東京都,千代田区,外神田６,1,0,0,0,0,4,5,4,11,80000,150000,東京メトロ銀座線,末広町駅,2,75000,5000,75000,75000,80000,0,0.0
コトー駿河台,東京都,千代田区,神田駿河台１,1,0,0,0,0,48,9,6,15,75000,0,ＪＲ中央線,御茶ノ水駅,6,75000,0,0,0,73000,2000,2.7
シティタワー・ルフォン九段の杜,東京都,千代田区,九段北４,2,1,0,1,0,5,19,9,70,390000,1170000,東京メトロ有楽町線,市ケ谷駅,5,390000,0,780000,390000,405000,-15000,3.8
都営新宿線馬喰横山駅10階建築20年,東京都,千代田区,東神田１,1,0,0,0,0,20,10,2,23,92000,85000,都営新宿線,馬喰横山駅,3,85000,7000,85000,0,92000,0,0.0
都営新宿線岩本町駅14階建築20年,東京都,千代田区,岩本町２,1,0,0,0,0,20,14,12,22,95000,0,都営新宿線,岩本町駅,7,87000,8000,0,0,90000,5000,5.3
ＪＲ山手線秋葉原駅5階建築52年,東京都,千代田区,外神田３,2,1,0,0,0,52,5,3,37,130000,520000,ＪＲ山手線,秋葉原駅,5,130000,0,260000,260000,200000,-70000,53.8
ザ・パークハウスグラン三番町,東京都,千代田区,三番町,2,1,0,1,0,9,15,3,60,380000,760000,東京メトロ半蔵門線,半蔵門駅,7,380000,0,380000,380000,380000,0,0.0
ＪＲ山手線神田駅9階建築5年,東京都,千代田区,神田富山町,1,0,0,0,0,5,9,2,24,131000,123000,ＪＲ山手線,神田駅,4,123000,8000,123000,0,131000,0,0.0
パレステュディオ神田神保町,東京都,千代田区,神田神保町２,1,0,0,0,0,19,14,3,22,94500,172000,東京メトロ半蔵門線,神保町駅,1,86000,8500,86000,86000,94500,0,0.0
カッシア神田レジデンス,東京都,千代田区,神田東紺屋町,1,1,0,1,0,16,10,10,51,239000,458000,ＪＲ山手線,神田駅,2,229000,10000,229000,229000,239000,0,0.0
ライオンズマンション九段第２,東京都,千代田区,九段南３,1,0,0,0,0,42,8,7,20,77000,75000,ＪＲ中央線,飯田橋駅,17,75000,2000,75000,0,77400,-400,0.5
ＪＲ中央線御茶ノ水駅12階建築6年,東京都,千代田区,神田神保町１,1,0,0,0,0,6,12,9,25,135000,250000,ＪＲ中央線,御茶ノ水駅,10,125000,10000,125000,125000,135000,0,0.0
岩本町酒井マンション,東京都,千代田区,岩本町２,1,0,0,0,0,45,5,5,15,73000,136000,都営新宿線,岩本町駅,3,68000,5000,68000,68000,73000,0,0.0
東京メトロ東西線九段下駅8階建築25年,東京都,千代田区,九段北１,1,1,0,0,0,25,8,4,32,129000,119000,東京メトロ東西線,九段下駅,3,119000,10000,119000,0,129000,0,0.0
ＪＲ総武線秋葉原駅地下2地上21階建築4年,東京都,千代田区,神田練塀町,1,1,0,1,0,4,21,19,46,299000,598000,ＪＲ総武線,秋葉原駅,3,299000,0,598000,0,260000,39000,13.0
シティカレント大手町,東京都,千代田区,神田錦町１,1,0,0,0,0,18,14,9,24,108000,98000,東京メトロ東西線,大手町駅,5,98000,10000,98000,0,108000,0,0.0
東京メトロ半蔵門線半蔵門駅14階建築18年,東京都,千代田区,麹町３,1,1,0,1,0,18,14,7,62,304000,568000,東京メトロ半蔵門線,半蔵門駅,3,284000,20000,284000,284000,300000,4000,1.3
東京メトロ銀座線末広町駅10階建築9年,東京都,千代田区,外神田６,1,0,0,0,0,9,10,3,24,118000,0,東京メトロ銀座線,末広町駅,3,103000,15000,0,0,131000,-13000,11.0
プライムメゾン神保町,東京都,千代田区,神田神保町１,1,0,0,0,0,10,14,13,25,135000,250000,東京メトロ半蔵門線,神保町駅,5,125000,10000,125000,125000,135000,0,0.0
パレステュディオ三番町,東京都,千代田区,三番町,1,0,0,0,1,21,9,6,30,123000,114500,東京メトロ半蔵門線,半蔵門駅,6,114500,8500,0,114500,125000,-2000,1.6
シルキーハイツ九段南,東京都,千代田区,九段南４,1,0,0,0,0,41,7,4,33,110000,200000,都営新宿線,市ケ谷駅,3,100000,10000,100000,100000,120000,-10000,9.1
明君モナーク九段,東京都,千代田区,九段北４,1,0,0,0,0,42,9,4,18,75000,150000,都営新宿線,市ケ谷駅,3,75000,0,75000,75000,82000,-7000,9.3
パークハウス平河町,東京都,千代田区,平河町１,2,1,0,1,0,16,14,11,64,330000,660000,東京メトロ有楽町線,麹町駅,4,330000,0,330000,330000,330000,0,0.0
グランドメゾン一番町,東京都,千代田区,一番町,1,1,0,1,0,1,9,6,44,198000,340000,東京メトロ半蔵門線,半蔵門駅,1,170000,28000,170000,170000,170000,28000,14.1
東京メトロ有楽町線麹町駅13階建築14年,東京都,千代田区,二番町,2,1,0,1,1,14,13,11,123,740000,1480000,東京メトロ有楽町線,麹町駅,1,740000,0,1480000,0,740000,0,0.0
東京メトロ丸ノ内線大手町駅12階建築16年,東京都,千代田区,内神田１,1,0,0,0,0,16,12,4,22,99000,84000,東京メトロ丸ノ内線,大手町駅,7,84000,15000,0,84000,96000,3000,3.0
プレシス東神田,東京都,千代田区,東神田１,1,1,0,1,0,11,13,4,39,171000,330000,ＪＲ総武線快速,馬喰町駅,5,165000,6000,165000,165000,171000,0,0.0
東京メトロ半蔵門線半蔵門駅8階建築24年,東京都,千代田区,平河町１,1,1,0,1,0,24,8,4,73,280000,560000,東京メトロ半蔵門線,半蔵門駅,3,280000,0,280000,280000,302000,-22000,7.9
バンブー岩本町,東京都,千代田区,岩本町２,1,1,0,0,0,17,13,6,39,140000,260000,都営新宿線,岩本町駅,5,130000,10000,130000,130000,160000,-20000,14.3
リヴシティ一番町,東京都,千代田区,一番町,1,0,0,0,0,10,12,4,25,119000,0,東京メトロ半蔵門線,半蔵門駅,2,109000,10000,0,0,108000,11000,9.2
東京メトロ南北線市ケ谷駅10階建築20年,東京都,千代田区,九段南２,1,0,0,0,0,20,10,5,23,100000,170000,東京メトロ南北線,市ケ谷駅,7,85000,15000,85000,85000,85000,15000,15.0
東京メトロ東西線九段下駅11階建新築,東京都,千代田区,飯田橋２,1,0,0,0,0,0,11,2,25,129000,228000,東京メトロ東西線,九段下駅,4,114000,15000,114000,114000,129000,0,0.0
プライムアーバン千代田富士見,東京都,千代田区,富士見２,1,0,0,0,0,20,10,9,22,114000,108000,東京メトロ東西線,飯田橋駅,4,108000,6000,108000,0,105000,9000,7.9
ＪＲ山手線秋葉原駅12階建築19年,東京都,千代田区,岩本町３,1,0,0,0,0,19,12,4,24,106000,0,ＪＲ山手線,秋葉原駅,8,96000,10000,0,0,106000,0,0.0
高梨ビル,東京都,千代田区,神田司町２,1,0,0,0,0,44,5,2,23,79000,74000,東京メトロ丸ノ内線,淡路町駅,3,74000,5000,74000,0,79000,0,0.0
カスタリア神保町,東京都,千代田区,神田神保町２,1,0,0,0,0,19,11,2,26,123000,115000,東京メトロ半蔵門線,神保町駅,3,115000,8000,115000,0,120500,2500,2.0
ＪＲ中央線御茶ノ水駅13階建築7年,東京都,千代田区,神田猿楽町１,1,1,0,0,0,7,13,3,24,128000,236000,ＪＲ中央線,御茶ノ水駅,8,118000,10000,118000,118000,128000,0,0.0
東京メトロ半蔵門線半蔵門駅地下2地上14階建築22年,東京都,千代田区,一番町,3,1,0,1,0,22,14,10,120,670000,2010000,東京メトロ半蔵門線,半蔵門駅,3,670000,0,1340000,670000,670000,0,0.0
TK猿楽町レジデンス,東京都,千代田区,神田猿楽町２,2,1,0,1,0,7,9,4,56,256000,492000,東京メトロ半蔵門線,神保町駅,5,246000,10000,246000,246000,256000,0,0.0
東京メトロ半蔵門線半蔵門駅9階建築1年,東京都,千代田区,一番町,1,1,0,1,0,1,9,6,44,198000,340000,東京メトロ半蔵門線,半蔵門駅,1,170000,28000,170000,170000,170000,28000,14.1
Ｑｕ４ｔｔｒｏ　Ａｒｃａ　九段,東京都,千代田区,九段北１,1,1,0,1,1,4,12,10,50,235000,225000,東京メトロ半蔵門線,九段下駅,3,225000,10000,225000,0,275000,-40000,17.0
Y’stower,東京都,千代田区,神田佐久間町２,2,0,0,0,0,18,11,2,44,160880,150000,ＪＲ山手線,秋葉原駅,2,150000,10880,150000,0,144000,16880,10.5
一ツ橋フォレスター,東京都,千代田区,一ツ橋２,1,0,0,0,0,22,12,6,30,119000,228000,都営三田線,神保町駅,2,114000,5000,114000,114000,119000,0,0.0
ＪＲ中央線四ツ谷駅7階建築16年,東京都,千代田区,六番町,1,1,0,1,1,16,7,2,76,350000,1050000,ＪＲ中央線,四ツ谷駅,6,350000,0,350000,700000,350000,0,0.0
ＪＲ山手線秋葉原駅15階建築18年,東京都,千代田区,岩本町３,1,0,0,0,0,18,15,11,26,104000,288000,ＪＲ山手線,秋葉原駅,6,96000,8000,96000,192000,104000,0,0.0
ＪＲ総武線市ケ谷駅10階建築20年,東京都,千代田区,三番町,1,0,0,0,0,20,10,5,23,131500,121000,ＪＲ総武線,市ケ谷駅,7,121000,10500,0,121000,95000,36500,27.8
東京メトロ千代田線新御茶ノ水駅13階建築41年,東京都,千代田区,神田小川町３,1,0,0,0,0,41,13,6,19,73000,146000,東京メトロ千代田線,新御茶ノ水駅,8,73000,0,73000,73000,82000,-9000,12.3
ダイナシティ神保町,東京都,千代田区,神田神保町２,1,1,0,1,0,16,14,3,32,139000,408000,都営三田線,神保町駅,3,136000,3000,272000,136000,139000,0,0.0
メゾン・ド・ヴィレ神田神保町,東京都,千代田区,神田神保町２,1,0,0,0,0,23,9,5,27,102000,0,東京メトロ半蔵門線,神保町駅,1,88000,14000,0,0,102000,0,0.0
九段リハイム,東京都,千代田区,九段北１,1,0,0,0,0,38,11,6,20,92500,82000,東京メトロ半蔵門線,九段下駅,3,82000,10500,0,82000,92500,0,0.0
東京メトロ千代田線大手町駅13階建築9年,東京都,千代田区,内神田１,1,1,0,1,1,9,13,2,46,225000,430000,東京メトロ千代田線,大手町駅,6,215000,10000,215000,215000,225000,0,0.0
ＪＲ総武線市ケ谷駅13階建築5年,東京都,千代田区,九段南２,1,1,0,1,0,5,13,2,40,178000,332000,ＪＲ総武線,市ケ谷駅,8,166000,12000,166000,166000,178000,0,0.0
プルミエール一番町,東京都,千代田区,一番町,2,1,0,1,0,26,9,7,89,375000,1125000,東京メトロ半蔵門線,半蔵門駅,2,375000,0,750000,375000,325000,50000,13.3
パークアクシス秋葉原,東京都,千代田区,神田佐久間町３,1,0,0,0,0,17,9,2,24,115000,214000,都営新宿線,岩本町駅,8,107000,8000,107000,107000,115000,0,0.0
ＪＲ総武線浅草橋駅10階建築16年,東京都,千代田区,東神田３,1,0,0,0,0,16,10,4,24,90000,164000,ＪＲ総武線,浅草橋駅,4,82000,8000,82000,82000,90000,0,0.0
東京メトロ有楽町線麹町駅15階建築9年,東京都,千代田区,平河町１,1,0,0,0,0,9,15,4,25,144000,268000,東京メトロ有楽町線,麹町駅,2,134000,10000,134000,134000,139000,5000,3.5
東京メトロ丸ノ内線淡路町駅14階建築8年,東京都,千代田区,内神田１,1,0,0,0,0,8,14,7,25,129000,258000,東京メトロ丸ノ内線,淡路町駅,4,129000,0,129000,129000,139000,-10000,7.8
ＪＲ総武線浅草橋駅14階建築18年,東京都,千代田区,東神田１,1,0,0,0,0,18,14,6,34,108000,103000,ＪＲ総武線,浅草橋駅,3,103000,5000,0,103000,136000,-28000,25.9
千代田レジデンス,東京都,千代田区,岩本町３,1,0,0,0,0,19,5,3,21,88000,80000,都営新宿線,岩本町駅,5,80000,8000,80000,0,90000,-2000,2.3
ＪＲ山手線秋葉原駅12階建築18年,東京都,千代田区,東神田２,1,0,0,0,0,18,12,6,22,94000,87000,ＪＲ山手線,秋葉原駅,8,87000,7000,0,87000,96000,-2000,2.1
LEO九段BUILDING,東京都,千代田区,九段北１,1,0,0,0,0,18,13,10,37,160000,150000,東京メトロ東西線,九段下駅,1,150000,10000,150000,0,175000,-15000,9.4
パレステュディオ神田EAST,東京都,千代田区,東神田１,1,0,0,0,0,20,8,4,22,95000,0,ＪＲ山手線,神田駅,10,80000,15000,0,0,95000,0,0.0
グランツルクサス神田,東京都,千代田区,神田須田町１,1,1,0,0,0,4,9,7,25,136000,0,東京メトロ銀座線,神田駅,1,124000,12000,0,0,137000,-1000,0.7
フォレシティ神田多町,東京都,千代田区,神田多町２,1,0,0,0,0,16,12,9,33,142000,132000,ＪＲ中央線,御茶ノ水駅,9,132000,10000,0,132000,142000,0,0.0
アイフェリーク神田,東京都,千代田区,神田東紺屋町,1,0,0,0,0,18,13,11,22,89000,0,ＪＲ山手線,秋葉原駅,7,79000,10000,0,0,93000,-4000,4.5
シュロス神田五軒町ツインフォルム,東京都,千代田区,外神田６,1,0,0,0,0,24,11,5,25,103000,206000,東京メトロ銀座線,末広町駅,3,103000,0,103000,103000,110000,-7000,6.8
THEAXISKOJIMACHI(ジアクシス麹町),東京都,千代田区,平河町２,1,1,0,1,0,4,10,10,51,248000,472000,東京メトロ有楽町線,麹町駅,3,236000,12000,236000,236000,239000,9000,3.6
ＪＲ山手線秋葉原駅12階建築16年,東京都,千代田区,東神田２,1,0,0,0,0,16,12,8,30,133000,120000,ＪＲ山手線,秋葉原駅,7,120000,13000,0,120000,133000,0,0.0
ＪＲ山手線秋葉原駅12階建築22年,東京都,千代田区,神田佐久間町４,1,0,0,0,0,22,12,4,20,99500,89000,ＪＲ山手線,秋葉原駅,6,89000,10500,0,89000,99500,0,0.0
ＪＲ中央線市ケ谷駅12階建築10年,東京都,千代田区,一番町,1,0,0,0,0,10,12,4,25,119000,0,ＪＲ中央線,市ケ谷駅,9,109000,10000,0,0,108000,11000,9.2
東京メトロ有楽町線麹町駅15階建築17年,東京都,千代田区,二番町,1,0,0,0,0,17,15,13,36,175000,165000,東京メトロ有楽町線,麹町駅,1,165000,10000,165000,0,175000,0,0.0
ＪＲ中央線水道橋駅14階建築1年,東京都,千代田区,神田猿楽町２,1,1,0,0,0,1,14,6,25,145000,130000,ＪＲ中央線,水道橋駅,6,130000,15000,130000,0,145000,0,0.0
こもれび神田神保町,東京都,千代田区,神田神保町２,1,0,0,0,0,15,10,4,33,152300,411000,東京メトロ半蔵門線,神保町駅,3,137000,15300,411000,0,152300,0,0.0
誠心IIビル,東京都,千代田区,東神田１,1,0,0,0,0,33,7,2,19,75000,144000,ＪＲ総武線快速,馬喰町駅,3,72000,3000,72000,72000,75000,0,0.0
東京メトロ半蔵門線半蔵門駅5階建築22年,東京都,千代田区,平河町２,1,1,0,1,0,22,5,2,39,180000,172000,東京メトロ半蔵門線,半蔵門駅,5,172000,8000,172000,0,180000,0,0.0
東京メトロ半蔵門線半蔵門駅10階建築20年,東京都,千代田区,麹町２,1,1,0,0,0,20,10,7,34,149000,278000,東京メトロ半蔵門線,半蔵門駅,2,139000,10000,139000,139000,161000,-12000,8.1
ＪＲ山手線神田駅4階建築51年,東京都,千代田区,岩本町２,1,0,0,0,0,51,4,3,7,55000,0,ＪＲ山手線,神田駅,8,51700,3300,0,0,68000,-13000,23.6
東京メトロ半蔵門線半蔵門駅6階建築19年,東京都,千代田区,平河町２,1,0,0,0,0,19,6,1,42,132000,240000,東京メトロ半蔵門線,半蔵門駅,5,120000,12000,120000,120000,142000,-10000,7.6
ベルファース秋葉原,東京都,千代田区,神田練塀町,1,1,0,1,0,18,19,17,50,225000,450000,ＪＲ山手線,秋葉原駅,4,225000,0,450000,0,250000,-25000,11.1
ヴィラージュ・ド・クロシェビル,東京都,千代田区,神田練塀町,1,1,0,1,0,7,10,6,35,220000,792000,ＪＲ山手線,秋葉原駅,4,198000,22000,594000,198000,160000,60000,27.3
ガラ・ステーション岩本町Ｎｏｒｔｈ,東京都,千代田区,岩本町３,1,0,0,0,0,18,12,2,22,94000,170000,ＪＲ山手線,秋葉原駅,5,85000,9000,85000,85000,88000,6000,6.4
メイゾン麹町,東京都,千代田区,麹町３,1,0,0,0,0,41,10,5,32,150000,300000,東京メトロ有楽町線,麹町駅,1,150000,0,150000,150000,160000,-10000,6.7
東京メトロ有楽町線麹町駅8階建築46年,東京都,千代田区,平河町１,1,1,0,0,0,46,8,4,24,100000,194000,東京メトロ有楽町線,麹町駅,3,97000,3000,97000,97000,128000,-28000,28.0
(仮称)山口ビル2021,東京都,千代田区,外神田３,1,1,0,1,0,0,8,4,42,176000,342000,東京メトロ銀座線,末広町駅,3,171000,5000,171000,171000,182000,-6000,3.4
三番町東急アパートメント,東京都,千代田区,三番町,3,1,0,1,0,23,11,10,208,1000000,2000000,東京メトロ半蔵門線,半蔵門駅,7,1000000,0,1000000,1000000,670000,330000,33.0
スペランツァ日本橋,東京都,千代田区,鍛冶町１,1,0,0,0,0,3,12,3,21,116000,0,ＪＲ山手線,神田駅,5,105000,11000,0,0,116000,0,0.0
ＪＲ山手線秋葉原駅13階建築17年,東京都,千代田区,東神田１,1,1,0,1,0,17,13,7,41,170000,320000,ＪＲ山手線,秋葉原駅,6,160000,10000,160000,160000,174000,-4000,2.4
ＪＲ山手線神田駅13階建築18年,東京都,千代田区,神田紺屋町,1,0,0,0,0,18,13,11,22,90000,160000,ＪＲ山手線,神田駅,5,80000,10000,80000,80000,93000,-3000,3.3
ガーラ神田岩本町,東京都,千代田区,岩本町２,1,0,0,0,0,17,14,7,27,105000,288000,東京メトロ日比谷線,小伝馬町駅,7,96000,9000,96000,192000,105000,0,0.0
東京メトロ丸ノ内線大手町駅16階建新築,東京都,千代田区,内神田１,1,0,0,0,0,0,16,3,28,150000,280000,東京メトロ丸ノ内線,大手町駅,4,140000,10000,140000,140000,150000,0,0.0
都営三田線神保町駅9階建築19年,東京都,千代田区,神田神保町１,1,0,0,0,0,19,9,8,22,122500,112000,都営三田線,神保町駅,2,112000,10500,0,112000,122500,0,0.0
メインステージ秋葉原駅前,東京都,千代田区,外神田１,1,0,0,0,0,20,12,4,22,96000,88000,ＪＲ山手線,秋葉原駅,4,88000,8000,0,88000,100000,-4000,4.2
ルネサンスコート秋葉原,東京都,千代田区,東神田１,1,1,0,1,1,2,13,4,47,231000,0,東京メトロ日比谷線,小伝馬町駅,5,221000,10000,0,0,185000,46000,19.9
ＪＲ山手線秋葉原駅13階建築2年,東京都,千代田区,東神田１,1,1,0,1,1,2,13,4,47,231000,0,ＪＲ山手線,秋葉原駅,9,221000,10000,0,0,185000,46000,19.9
都営新宿線市ケ谷駅7階建築41年,東京都,千代田区,九段南４,1,0,0,0,0,41,7,4,33,110000,200000,都営新宿線,市ケ谷駅,2,100000,10000,100000,100000,120000,-10000,9.1
東京メトロ半蔵門線半蔵門駅5階建築28年,東京都,千代田区,三番町,2,1,0,1,0,28,5,4,51,200000,380000,東京メトロ半蔵門線,半蔵門駅,5,190000,10000,190000,190000,200000,0,0.0
ライオンズマンション麹町桔梗,東京都,千代田区,麹町２,2,1,0,1,0,43,8,3,51,200000,400000,東京メトロ有楽町線,麹町駅,3,200000,0,200000,200000,200000,0,0.0
ＪＲ山手線秋葉原駅4階建築24年,東京都,千代田区,神田和泉町,3,1,0,1,1,24,4,3,93,400000,1200000,ＪＲ山手線,秋葉原駅,4,400000,0,800000,400000,400000,0,0.0
ビラビスタ猿楽町,東京都,千代田区,神田猿楽町１,1,0,0,0,0,7,8,2,21,108000,100000,都営三田線,神保町駅,3,100000,8000,100000,0,107000,1000,0.9
プレシス半蔵門,東京都,千代田区,麹町１,1,1,0,1,0,11,13,11,51,263000,753000,東京メトロ半蔵門線,半蔵門駅,1,251000,12000,502000,251000,254000,9000,3.4
東京メトロ半蔵門線神保町駅5階建築4年,東京都,千代田区,神田神保町１,1,1,0,1,0,4,5,3,33,171000,342000,東京メトロ半蔵門線,神保町駅,2,171000,0,171000,171000,171000,0,0.0
アピス一番町,東京都,千代田区,一番町,1,1,0,1,0,13,10,5,46,225000,430000,東京メトロ半蔵門線,半蔵門駅,3,215000,10000,215000,215000,230000,-5000,2.2
ＪＲ山手線秋葉原駅13階建築22年,東京都,千代田区,神田和泉町,1,0,0,0,0,22,13,9,22,100500,0,ＪＲ山手線,秋葉原駅,3,85500,15000,0,0,100500,0,0.0
東京メトロ半蔵門線半蔵門駅地下1地上19階建築15年,東京都,千代田区,一番町,2,1,0,1,0,15,19,9,68,350000,670000,東京メトロ半蔵門線,半蔵門駅,2,335000,15000,335000,335000,380000,-30000,8.6
ザ・サンメゾン二番町エルド,東京都,千代田区,二番町,3,1,0,1,0,8,11,2,85,465000,930000,東京メトロ有楽町線,麹町駅,3,465000,0,465000,465000,380000,85000,18.3
アイフェリーク神田,東京都,千代田区,神田紺屋町,1,0,0,0,0,18,13,11,22,90000,160000,都営新宿線,岩本町駅,5,80000,10000,80000,80000,93000,-3000,3.3
東京メトロ丸ノ内線御茶ノ水駅9階建築48年,東京都,千代田区,神田駿河台１,1,0,0,0,0,48,9,6,15,75000,0,東京メトロ丸ノ内線,御茶ノ水駅,5,75000,0,0,0,73000,2000,2.7
麹町パーソナルハウス,東京都,千代田区,麹町２,1,1,0,1,0,42,5,4,42,170000,850000,東京メトロ半蔵門線,半蔵門駅,2,170000,0,680000,170000,187000,-17000,10.0
東京メトロ日比谷線小伝馬町駅12階建築9年,東京都,千代田区,岩本町１,1,1,0,1,0,9,12,5,40,174000,164000,東京メトロ日比谷線,小伝馬町駅,2,164000,10000,0,164000,174000,0,0.0
ＪＲ総武線市ケ谷駅13階建築52年,東京都,千代田区,五番町,3,1,0,1,0,52,13,1,98,350000,693000,ＪＲ総武線,市ケ谷駅,4,330000,20000,330000,363000,350000,0,0.0
ＪＲ山手線神田駅8階建築8年,東京都,千代田区,神田須田町１,1,1,0,1,0,8,8,5,42,179000,354900,ＪＲ山手線,神田駅,3,169000,10000,169000,185900,179000,0,0.0
東京メトロ半蔵門線半蔵門駅14階建新築,東京都,千代田区,麹町２,1,1,0,1,0,0,14,2,65,298500,572000,東京メトロ半蔵門線,半蔵門駅,1,286000,12500,286000,286000,306500,-8000,2.7
東京メトロ東西線九段下駅7階建築45年,東京都,千代田区,飯田橋１,1,1,0,0,0,45,7,7,43,180000,540000,東京メトロ東西線,九段下駅,3,180000,0,360000,180000,160000,20000,11.1
ポローニア秋葉原,東京都,千代田区,神田佐久間町３,1,1,0,1,0,14,4,2,41,136260,520000,ＪＲ山手線,秋葉原駅,4,130000,6260,390000,130000,150000,-13740,10.1
グレース東神田,東京都,千代田区,東神田２,1,0,0,0,0,21,10,5,28,101000,190000,ＪＲ山手線,秋葉原駅,7,95000,6000,95000,95000,102000,-1000,1.0
ＪＲ山手線神田駅12階建築19年,東京都,千代田区,神田司町２,1,0,0,0,0,19,12,5,23,102000,184000,ＪＲ山手線,神田駅,6,92000,10000,92000,92000,102000,0,0.0
東京メトロ半蔵門線半蔵門駅9階建築41年,東京都,千代田区,平河町１,1,0,0,0,0,41,9,8,19,82000,164000,東京メトロ半蔵門線,半蔵門駅,3,82000,0,82000,82000,82000,0,0.0
グランヴィスタ神田練塀町,東京都,千代田区,神田練塀町,1,1,0,1,0,4,23,19,46,299000,598000,ＪＲ山手線,秋葉原駅,1,299000,0,598000,0,260000,39000,13.0
スカイコートお茶の水,東京都,千代田区,神田猿楽町２,1,0,0,0,0,16,7,6,22,104000,208000,ＪＲ中央線,水道橋駅,6,104000,0,104000,104000,111000,-7000,6.7
PARKAXIS小伝馬町　【パークアクシス小伝馬町】,東京都,千代田区,岩本町１,1,1,0,1,0,19,14,8,40,186000,173000,ＪＲ山手線,神田駅,10,173000,13000,173000,0,183000,3000,1.6
ＪＲ総武線浅草橋駅12階建築18年,東京都,千代田区,東神田３,1,0,0,0,0,18,12,4,22,95000,180000,ＪＲ総武線,浅草橋駅,3,90000,5000,90000,90000,95000,0,0.0
和泉町中央ビル,東京都,千代田区,神田和泉町,1,0,0,0,0,33,6,6,26,110000,300000,ＪＲ山手線,秋葉原駅,4,100000,10000,200000,100000,120000,-10000,9.1
FLATS一番町,東京都,千代田区,一番町,1,0,0,0,0,19,9,3,35,138000,256000,東京メトロ半蔵門線,半蔵門駅,2,128000,10000,128000,128000,144000,-6000,4.3
桜ヒルズ九段北,東京都,千代田区,九段北４,1,0,0,0,0,9,9,5,25,122000,236000,ＪＲ中央線,市ケ谷駅,5,118000,4000,118000,118000,122000,0,0.0
ＪＲ山手線神田駅16階建新築,東京都,千代田区,内神田１,1,0,0,0,0,0,16,3,28,150000,280000,ＪＲ山手線,神田駅,8,140000,10000,140000,140000,150000,0,0.0
パレステュディオ御茶ノ水駿河台参番館,東京都,千代田区,神田錦町３,1,0,0,0,0,21,10,1,22,89000,85000,東京メトロ半蔵門線,神保町駅,6,85000,4000,0,85000,89000,0,0.0
東京メトロ半蔵門線半蔵門駅地下1地上7階建築20年,東京都,千代田区,麹町２,1,0,0,0,0,20,7,4,39,159000,159000,東京メトロ半蔵門線,半蔵門駅,2,159000,0,159000,0,120000,39000,24.5
ＧＯＬＤ　ＦＯＲＥＳＴ　半蔵門（ゴールドフォレストハンゾウモン）,東京都,千代田区,麹町２,1,1,0,1,0,0,14,2,65,298500,572000,東京メトロ半蔵門線,半蔵門駅,2,286000,12500,286000,286000,306500,-8000,2.7
シャンブリーズ御茶ノ水,東京都,千代田区,神田小川町３,1,0,0,0,0,19,9,2,23,106000,0,都営新宿線,小川町駅,2,99000,7000,0,0,106000,0,0.0
ＪＲ総武線飯田橋駅地下1地上5階建築17年,東京都,千代田区,富士見２,1,1,0,1,0,17,5,5,54,245000,345000,ＪＲ総武線,飯田橋駅,5,230000,15000,345000,0,245000,0,0.0
ダイアパレス水道橋,東京都,千代田区,神田三崎町３,1,1,0,0,0,25,12,3,30,130000,115000,ＪＲ中央線,水道橋駅,3,115000,15000,0,115000,129000,1000,0.8
PEAKS神田,東京都,千代田区,神田西福田町,1,1,0,1,0,6,14,9,40,183000,173000,ＪＲ山手線,神田駅,5,173000,10000,173000,0,183000,0,0.0
ＪＲ総武線浅草橋駅12階建築20年,東京都,千代田区,東神田１,1,0,0,0,0,20,12,4,18,82000,150000,ＪＲ総武線,浅草橋駅,5,75000,7000,75000,75000,82000,0,0.0
ＪＲ中央線御茶ノ水駅5階建築20年,東京都,千代田区,神田猿楽町２,1,0,0,0,0,20,5,2,24,94000,178000,ＪＲ中央線,御茶ノ水駅,7,89000,5000,89000,89000,94000,0,0.0
コンフォリア秋葉原EAST,東京都,千代田区,東神田２,1,0,0,0,0,7,12,6,25,124000,118000,ＪＲ山手線,秋葉原駅,8,118000,6000,118000,0,124000,0,0.0
東京メトロ有楽町線麹町駅地下4地上17階建築23年,東京都,千代田区,二番町,1,1,0,1,0,23,17,3,53,320000,640000,東京メトロ有楽町線,麹町駅,4,320000,0,320000,320000,298000,22000,6.9
ＪＲ山手線神田駅4階建築44年,東京都,千代田区,東神田１,1,0,0,0,0,44,4,1,5,58000,0,ＪＲ山手線,神田駅,10,47000,11000,0,0,68000,-10000,17.2
パレステュディオ三番町2,東京都,千代田区,三番町,1,0,0,0,0,20,10,5,23,131500,121000,ＪＲ総武線,市ケ谷駅,7,121000,10500,0,121000,95000,36500,27.8
ロイジェント東神田,東京都,千代田区,東神田１,1,0,0,0,0,5,13,5,27,129000,119000,ＪＲ山手線,秋葉原駅,9,119000,10000,119000,0,129000,0,0.0
ＪＲ山手線神田駅12階建築5年,東京都,千代田区,神田西福田町,1,0,0,0,0,5,12,4,28,145000,270000,ＪＲ山手線,神田駅,5,135000,10000,135000,135000,145000,0,0.0
都営三田線神保町駅4階建築19年,東京都,千代田区,神田神保町１,1,0,0,0,0,19,4,3,27,106000,202000,都営三田線,神保町駅,3,101000,5000,101000,101000,106000,0,0.0
東京メトロ東西線九段下駅8階建築45年,東京都,千代田区,神田神保町３,1,0,0,0,0,45,8,4,15,72000,0,東京メトロ東西線,九段下駅,3,72000,0,0,0,73000,-1000,1.4
ＪＲ山手線神田駅13階建築4年,東京都,千代田区,内神田１,1,0,0,0,0,4,13,2,25,149000,278000,ＪＲ山手線,神田駅,5,139000,10000,139000,139000,150000,-1000,0.7
パークルール神田司町ロンド,東京都,千代田区,神田司町２,2,1,0,1,0,5,12,6,44,259000,239000,東京メトロ丸ノ内線,淡路町駅,3,239000,20000,239000,0,259000,0,0.0
ＪＲ総武線浅草橋駅11階建新築,東京都,千代田区,東神田３,2,1,0,1,0,0,11,6,51,262000,0,ＪＲ総武線,浅草橋駅,6,244000,18000,0,0,262000,0,0.0
ハミルトンプレイス,東京都,千代田区,三番町,2,1,0,1,0,17,9,8,156,665000,1300000,東京メトロ東西線,九段下駅,9,650000,15000,650000,650000,665000,0,0.0
Ｌａ　Ｐｅｒｌａ岩本町,東京都,千代田区,岩本町２,1,1,0,1,0,3,9,7,36,165000,300000,都営新宿線,岩本町駅,5,150000,15000,150000,150000,165000,0,0.0
ＪＲ中央線御茶ノ水駅12階建築8年,東京都,千代田区,神田神保町１,1,0,0,0,0,8,12,2,25,111000,99000,ＪＲ中央線,御茶ノ水駅,8,99000,12000,0,99000,100000,11000,9.9
宮島ビル,東京都,千代田区,飯田橋１,1,0,0,0,0,39,6,4,14,73000,146000,東京メトロ東西線,飯田橋駅,5,73000,0,73000,73000,73000,0,0.0
フェルクルール秋葉原,東京都,千代田区,外神田６,1,0,0,0,0,9,10,3,24,118000,0,東京メトロ銀座線,末広町駅,3,103000,15000,0,0,131000,-13000,11.0
シュトラーレ四番町,東京都,千代田区,四番町,1,1,0,1,0,3,4,4,46,222000,218000,都営新宿線,市ケ谷駅,4,218000,4000,0,218000,198000,24000,10.8
トーア岩本町マンション,東京都,千代田区,岩本町１,1,0,0,0,0,42,9,2,18,83000,0,東京メトロ日比谷線,小伝馬町駅,5,74000,9000,0,0,77400,5600,6.7
パークタワー秋葉原,東京都,千代田区,神田練塀町,2,1,0,1,0,17,22,16,59,268000,759000,ＪＲ山手線,秋葉原駅,4,253000,15000,253000,506000,268000,0,0.0
ＪＲ中央線市ケ谷駅9階建築2年,東京都,千代田区,三番町,2,1,0,1,0,2,9,8,63,299000,558000,ＪＲ中央線,市ケ谷駅,9,279000,20000,279000,279000,270000,29000,9.7
ＪＲ総武線市ケ谷駅9階建築18年,東京都,千代田区,三番町,1,0,0,0,0,18,9,5,30,142000,270000,ＪＲ総武線,市ケ谷駅,7,135000,7000,135000,135000,142000,0,0.0
フレッシア永田町,東京都,千代田区,永田町２,1,0,0,0,0,21,10,2,40,161000,302000,東京メトロ丸ノ内線,赤坂見附駅,3,151000,10000,151000,151000,161000,0,0.0
アルビオ・ザ・タワー千代田飯田橋,東京都,千代田区,飯田橋４,1,1,0,1,0,2,24,7,44,260000,500000,東京メトロ東西線,飯田橋駅,2,250000,10000,250000,250000,260000,0,0.0
グレンパーク秋葉原イースト,東京都,千代田区,岩本町３,1,0,0,0,0,19,13,9,26,105000,186000,都営新宿線,岩本町駅,3,93000,12000,93000,93000,106000,-1000,1.0
坂の上テラス,東京都,千代田区,九段南２,1,0,0,0,0,14,10,3,31,143000,276000,東京メトロ東西線,九段下駅,7,138000,5000,276000,0,143000,0,0.0
ザ・パークハビオSOHO大手町,東京都,千代田区,内神田１,1,0,0,0,0,0,13,3,25,155000,135000,東京メトロ丸ノ内線,淡路町駅,5,135000,20000,135000,0,155000,0,0.0
VICOLOヴィコロ,東京都,千代田区,神田淡路町１,1,0,0,0,0,16,7,1,26,450000,1350000,東京メトロ千代田線,新御茶ノ水駅,1,450000,0,900000,450000,144000,306000,68.0
ＪＲ中央線市ケ谷駅地下1地上19階建築6年,東京都,千代田区,三番町,1,1,0,1,0,6,19,2,53,300000,560000,ＪＲ中央線,市ケ谷駅,6,280000,20000,280000,280000,300000,0,0.0
リブ九段,東京都,千代田区,九段北１,1,0,0,0,0,42,7,4,34,120000,220000,東京メトロ東西線,九段下駅,1,110000,10000,110000,110000,120000,0,0.0
アウラ九段,東京都,千代田区,九段南３,1,0,0,0,0,23,7,4,22,93000,0,都営新宿線,市ケ谷駅,5,87000,6000,0,0,95000,-2000,2.2
都営新宿線市ケ谷駅地下1地上8階建築34年,東京都,千代田区,九段南４,1,0,0,0,0,34,8,2,32,116000,318000,都営新宿線,市ケ谷駅,2,106000,10000,212000,106000,148000,-32000,27.6
ＪＲ中央線神田駅8階建築20年,東京都,千代田区,東神田１,1,0,0,0,0,20,8,4,22,95000,0,ＪＲ中央線,神田駅,10,80000,15000,0,0,95000,0,0.0
都営新宿線岩本町駅15階建築18年,東京都,千代田区,岩本町３,1,0,0,0,0,18,15,11,26,104000,288000,都営新宿線,岩本町駅,2,96000,8000,96000,192000,104000,0,0.0
ＪＲ中央線飯田橋駅16階建築39年,東京都,千代田区,飯田橋４,3,1,0,1,0,39,16,16,72,250000,420000,ＪＲ中央線,飯田橋駅,1,210000,40000,210000,210000,250000,0,0.0
東京メトロ半蔵門線神保町駅6階建築62年,東京都,千代田区,西神田２,1,0,0,0,0,62,6,5,13,65000,124000,東京メトロ半蔵門線,神保町駅,6,62000,3000,62000,62000,73000,-8000,12.3
半蔵門レジデンス,東京都,千代田区,平河町１,1,1,0,1,0,5,14,3,40,182000,546000,東京メトロ半蔵門線,半蔵門駅,3,167000,15000,364000,182000,182000,0,0.0
プチグランデ秋葉原,東京都,千代田区,神田佐久間町２,1,0,0,0,0,10,9,4,23,114000,212000,東京メトロ日比谷線,秋葉原駅,1,106000,8000,106000,106000,114000,0,0.0
東京メトロ半蔵門線半蔵門駅地下1地上16階建築9年,東京都,千代田区,平河町２,1,1,0,1,0,9,16,2,40,220000,440000,東京メトロ半蔵門線,半蔵門駅,7,220000,0,220000,220000,220000,0,0.0
ＪＲ総武線快速新日本橋駅15階建築20年,東京都,千代田区,岩本町１,1,1,0,1,0,20,15,4,37,159000,149000,ＪＲ総武線快速,新日本橋駅,3,149000,10000,149000,0,159000,0,0.0
番町パークハウス,東京都,千代田区,四番町,2,1,0,1,0,16,17,8,63,350000,1050000,ＪＲ中央線,市ケ谷駅,3,350000,0,700000,350000,380000,-30000,8.6
APEX秋葉原　エイペックス秋葉原,東京都,千代田区,外神田５,1,0,0,0,0,5,5,4,19,113000,107000,東京メトロ銀座線,末広町駅,3,107000,6000,107000,0,88000,25000,22.1
フラット九段南,東京都,千代田区,九段南３,1,0,0,0,0,37,8,4,23,91000,160000,都営新宿線,市ケ谷駅,4,80000,11000,80000,80000,74000,17000,18.7
ロジェ二番町,東京都,千代田区,二番町,1,0,0,0,0,18,10,4,43,158000,474000,東京メトロ有楽町線,麹町駅,2,158000,0,316000,158000,157000,1000,0.6
